111111111111111111111111111111
1E1000000000000000P000000000C1
100000000000000000000000000001
1000000000000C0000000000000001
101111111111110000000000000011
1000000000C00100000000000001C1
111111111111111111111111111111